R 1920 1080
NO ./textures/dog.xpm
EA ./textures/monalisa.xpm
WE ./textures/citizen.xpm
SO ./textures/wood.xpm

S ./textures/armor.xpm
F 50,100,0
C 0,0,0

        1111111111111111111111111
        1000000000110000000000001
        1011000001110000002000001
        1111000000000000000000001
111111111011000001110000000000001
100000000011000001110111111111111
11110111111111011100000010001
11110111111111011101010010001
11000000110101011100000000001
10002000000000000000000000001
10000000000000000000000002221
11000001110101011100000002N21
11110111111101011100000002221 
11111111111111111111111111111
