11111111111111111111
1E0000000000C0000011
10100101001000010101
10100100101010100111
1P0000000C00C00000C1
11111111111111111111